##################################################################################################################################################################################
####################################################################____________________________________________________##########################################################
################################################################_______________________________________________________________###################################################
###########################################################________________________________________________________________________###############################################
#######################################################________________________________________________________________________________###########################################
#####################################################___________________________________________________________________________________________##################################
##################################################_________________________________________________________________________________________________###############################
#########################################___________________________________________________________________________________________________________##############################
#####################################_____________________________________________________________________________________________________________________########################
###################################________________________________________________________________________________________________________________________#######################
###################################_________________________________________________________________________________________________________________________######################
##############################_______________________________________________________________________________________________________________________________#####################
##############################________________________________________________________________________________________________________________________________####################
##############################________________________________________________________________________________________________________________________________####################
###########################___________________________________________________________________________________________________________________________________####################
###########################___________________________________________________________________#######__________________________________________________________###################
##########################___________________________________________________________________##########________________________________________________________###################
##########################__________________________________________________________________#############################_______________________________________##################
#######################____________________________________________________________________#########____________________________________________________________##################
#####################_____________________________________________________________________##########____________________________________________________________##################
###################______________________________________________________________________________________________________________________________________________#################
##################________________________________________________________________________________________________________________________________________________################
#################__________________________________________________________________________________________________________________________________________________###############
#################__________________________________________________________________________________________________________________________________________________###############
################____________________________________________________________________________________________________________________________________________________##############
################_____________________________________________________________________________________________________________________________________________________#############
###############______________________________________________________________________________________________________________________________________________________#############
###############______________________________________________________________________________________________________________________________________________________#############
##############________________________________________________________________________________________________________________________________________________________############
##############________________________________________________________________________________________________________________________________________________________############
#############__________________________________________________________________________________________________________________________________________________________###########
#############___________________________________________________________________________________________________________________________________________________________##########
#############____________________________________________________________________________________________________________________________________________________________#########
#############____________________________________________________________________________________________________________________________________________________________#########
############______________________________________________________________________________________________________________________________________________________________########
############______________________________________________________________________________________________________________________________________________________________########
############______________________________________________________________________________________________________________________________________________________________########
############______________________________________________________________________________________________________________________________________________________________########
############______________________________________________________________________________________________________________________________________________________________########
############______________________________________________________________________________________________________________________________________________________________########
############______________________________________________________________________________________________________________________________________________________________########
############______________________________________________________________________________________________________________________________________________________________########
############______________________________________________________________________________________________________________________________________________________________########
############______________________________________________________________________________________________________________________________________________________________########
############______________________________________________________________________________________________________________________________________________________________########
############______________________________________________________________________________________________________________________________________________________________########
############______________________________________________________________________________________________________________________________________________________________########
############______________________________________________________________________________________________________________________________________________________________########
############______________________________________________________________________________________________________________________________________________________________########
############______________________________________________________________________________________________________________________________________________________________########
############______________________________________________________________________________________________________________________________________________________________########
############______________________________________________________________________________________________________________________________________________________________########
############______________________________________________________________________________________________________________________________________________________________########
############______________________________________________________________________________________________________________________________________________________________########
############______________________________________________________________________________________________________________________________________________________________########
############______________________________________________________________________________________________________________________________________________________________########
############______________________________________________________________________________________________________________________________________________________________########
############______________________________________________________________________________________________________________________________________________________________########
############______________________________________________________________________________________________________________________________________________________________########
############______________________________________________________________________________________________________________________________________________________________########
############______________________________________________________________________________________________________________________________________________________________########
############_____________________________________________________________________________________________________________________________________________________________#########
############____________________________________________________________________________________________________________________________________________________________##########
############___________________________________________________________________________________________________________________________________________________________###########
###############_______________________________________________________________________________________________________________________________________________________############
###############______________________________________________________________________________________________________________________________________________________#############
################____________________________________________________________________________________________________________________________________________________##############
################___________________________________________________________________________________________________________________________________________________###############
#################_________________________________________________________________________________________________________________________________________________################
##################_______________________________________________________________________________________________________________________________________________#################
###################____________________________________________________________________________________________________________________________________________###################
####################__________________________________________________________________________________________________________________________________________####################
#####################________________________________________________________________________________________________________________________________________#####################
######################______________________________________________________________________________________________________________________________________######################
#######################____________________________________________________________________________________________________________________________________#######################
########################__________________________________________________________________________________________________________________________________########################
#########################________________________________________________________________________________________________________________________________#########################
##########################______________________________________________________________________________________________________________________________##########################
###########################____________________________________________________________________________________________________________________________###########################
############################__________________________________________________________________________________________________________________________############################
#############################________________________________________________________________________________________________________________________#############################
##############################_____________________________________________________________________________________________________________________###############################
###############################__________________________________________________________________________________________________________________#################################
################################______________________________________________________________________________________________________________####################################
##################################_________________________________________________________________________________________________________#######################################
########################################################_______________________________________________________________________________###########################################
###############################################################____________________________________________________________________###############################################
######################################################################_________________________________________________________###################################################
############################################################################_____________________________________________#########################################################
#################################################################################____________________________________#############################################################
##################################################################################################################################################################################
##################################################################################################################################################################################
##################################################################################################################################################################################
##################################################################################################################################################################################
##################################################################################################################################################################################
##################################################################################################################################################################################
##################################################################################################################################################################################
##################################################################################################################################################################################
##################################################################################################################################################################################
##################################################################################################################################################################################
##################################################################################################################################################################################