##################################################################################################################################################################################
##################################################################################################################################################################################
##################################################################################################################################################################################
##################################################################################################################################################################################
##################################################################################################################################################################################
##################################################################################################################################################################################
#############################################################################___________________________##########################################################################
#############################################################______________________________________________________###############################################################
######################################################__________________________________________________________________________##################################################
###############################################_____________________________________________________________________________________##############################################
############################################____________________________________________________________________________________________##########################################
##########################################_____________________________________________________________________________________________________###################################
###################################___________________________________________________________________________________________________________________############################
################################__________________________________________________________________________________________________________________________########################
#############################______________________________________________________________________________________________________________________________#######################
##########################_____________________________________________________________________________________________________________________________________###################
########################________________________________________________________________________________________________________________________________________##################
######################_____________________________________________________________________________________________________________________________________________###############
##################___________________________________________________________________________________________________________________________________________________#############
#################_____________________________________________________________________________________________________________________________________________________############
################_______________________________________________________________________________________________________________________________________________________###########
##############_________________________________________________________________________________________________________________________________________________________###########
#############____________________________________________________________________________________________________________________________________________________________#########
############______________________________________________________________________________________________________________________________________________________________########
############______________________________________________________________________________________________________________________________________________________________########
#############_____________________________________________________________________________________________________________________________________________________________########
##############____________________________________________________________________________________________________________________________________________________________########
###############___________________________________________________________________________________________________________________________________________________________########
################__________________________________________________________________________________________________________________________________________________________########
################__________________________________________________________________________________________________________________________________________________________########
################________________________________________________________________________________________________________________________________________________________##########
################____________________________________________________________________________________________________________________________________________________##############
##################________________________________________________________________________________________________________________________________________________################
######################________________________________________________________________________________________________________________________________________####################
########################_____________________________________________________________________________________________________________________________________#####################
###########################________________________________________________________________________________________________________________________________#######################
#############################___________________________________________________________________________________________________________________________##########################
#################################___________________________________________________________________________________________________________________##############################
#####################################______________________________________________________________________________________________________________###############################
#########################################____________________________________________________________________________________________________#####################################
################################################_____________________________________________________________________________________#############################################
#######################################################_______________________________________________________________________####################################################
##################################################################____________________________________________________############################################################
######################################################################################________________############################################################################
##################################################################################################################################################################################
##################################################################################################################################################################################
##################################################################################################################################################################################
##################################################################################################################################################################################
##################################################################################################################################################################################
##################################################################################################################################################################################
##################################################################################################################################################################################