##################################################################################################################################################################################
##################################################################################################################################################################################
##################################################################################################################################################################################
##################################################################################################################################################################################
##################################################################################################################################################################################
######################################################################################________####################################################################################
####################################################################################__________####################################################################################
####################################################################################____________##################################################################################
############################################################################_____________________#################################################################################
####################################################################___________________________________###########################################################################
#################################################################________________________________________________#################################################################
#########################################################__________________________________________________________________#######################################################
##############################################____________________________________________________________________________________################################################
###########################################___________________________________________________________________________________________############################################
#######################################____________________________________________________________________________________________________#######################################
#####################################__________________________________________________________________________________________________________###################################
###################################______________________________________________________________________________________________________________#################################
################################_____________________________________________________________________________________________________________________#############################
##############################___________________________________________________________________________________________________________________________#########################
###########################_________________________________________________________________________________________________________________________________######################
#########################_____________________________________________________________________________________________________________________________________####################
########################_______________________________________________________________________________________________________________________________________###################
######################__________________________________________________________________________________________________________________________________________##################
####################_____________________________________________________________________________________________________________________________________________#################
###################_______________________________________________________________________________________________________________________________________________################
##################________________________________________________________________________________________________________________________________________________################
##################________________________________________________________________________________________________________________________________________________################
##################_______________________________________________________________________________________________________________________________________________#################
##################_______________________________________________________________________________________________________________________________________________#################
##################______________________________________________________________________________________________________________________________________________##################
##################______________________________________________________________________________________________________________________________________________##################
##################_____________________________________________________________________________________________________________________________________________###################
##################____________________________________________________________________________________________________________________________________________####################
####################________________________________________________________________________________________________________________________________________######################
######################____________________________________________________________________________________________________________________________________########################
########################_______________________________________________________________________________________________________________________________###########################
##########################___________________________________________________________________________________________________________________________#############################
#############################_____________________________________________________________________________________________________________________################################
################################_______________________________________________________________________________________________________________###################################
####################################_________________________________________________________________________________________________________#####################################
######################################__________________________________________________________________________________________________##########################################
##########################################__________________________________________________________________________________________##############################################
##############################################__________________________________________________________________________________##################################################
##################################################__________________________________________________________________________######################################################
############################################################________________________________________________________##############################################################
#######################################################################_________________________________##########################################################################
##################################################################################################################################################################################
##################################################################################################################################################################################
##################################################################################################################################################################################
##################################################################################################################################################################################
##################################################################################################################################################################################