##################################################################################################################################################################################
############____________________________________________________________________________________________________________________________________________________________________##
##______________________________________________________________________________________________________________________________________________________________________________##
##______________________________________________________________________________________________________________________________________________________________________________##
##______________________________________________________________________________________________________________________________________________________________________________##
##______________________________________________________________________________________________________________________________________________________________________________##
##______________________________________________________________________________________________________________________________________________________________________________##
##______________________________________________________________________________________________________________________________________________________________________________##
##______________________________________________________________________________________________________________________________________________________________________________##
##______________________________________________________________________________________________________________________________________________________________________________##
##______________________________________________________________________________________________________________________________________________________________________________##
##______________________________________________________________________________________________________________________________________________________________________________##
##______________________________________________________________________________________________________________________________________________________________________________##
##______________________________________________________________________________________________________________________________________________________________________________##
##______________________________________________________________________________________________________________________________________________________________________________##
##______________________________________________________________________________________________________________________________________________________________________________##
##______________________________________________________________________________________________________________________________________________________________________________##
##______________________________________________________________________________________________________________________________________________________________________________##
##______________________________________________________________________________________________________________________________________________________________________________##
##______________________________________________________________________________________________________________________________________________________________________________##
##______________________________________________________________________________________________________________________________________________________________________________##
##______________________________________________________________________________________________________________________________________________________________________________##
##______________________________________________________________________________________________________________________________________________________________________________##
##______________________________________________________________________________________________________________________________________________________________________________##
##______________________________________________________________________________________________________________________________________________________________________________##
##______________________________________________________________________________________________________________________________________________________________________________##
##______________________________________________________________________________________________________________________________________________________________________________##
##______________________________________________________________________________________________________________________________________________________________________________##
##______________________________________________________________________________________________________________________________________________________________________________##
##______________________________________________________________________________________________________________________________________________________________________________##
##______________________________________________________________________________________________________________________________________________________________________________##
##______________________________________________________________________________________________________________________________________________________________________________##
##______________________________________________________________________________________________________________________________________________________________________________##
##______________________________________________________________________________________________________________________________________________________________________________##
##______________________________________________________________________________________________________________________________________________________________________________##
##______________________________________________________________________________________________________________________________________________________________________________##
##______________________________________________________________________________________________________________________________________________________________________________##
##___________________________________________________________________################################___________________________________________________________________________##
##___________________________________________________________________################################___________________________________________________________________________##
##___________________________________________________________________################################___________________________________________________________________________##
##___________________________________________________________________################################___________________________________________________________________________##
##___________________________________________________________________################################___________________________________________________________________________##
##___________________________________________________________________################################___________________________________________________________________________##
##___________________________________________________________________################################___________________________________________________________________________##
##______________________________#######______________________________################################_____________________________________########______________________________##
####____________________________#######______________________________################################_____________________________________########______________________________##
####____________________________#######______________________________################################_____________________________________########______________________________##
####____________________________#######______________________________################################_____________________________________########______________________________##
####_________________________________________________________________################################___________________________________________________________________________##
##___________________________________________________________________################################___________________________________________________________________________##
##______________________________________________________________________________________________________________________________________________________________________________##
##______________________________________________________________________________________________________________________________________________________________________________##
##______________________________________________________________________________________________________________________________________________________________________________##
##______________________________________________________________________________________________________________________________________________________________________________##
##______________________________________________________________________________________________________________________________________________________________________________##
##______________________________________________________________________________________________________________________________________________________________________________##
##______________________________________________________________________________________________________________________________________________________________________________##
##______________________________________________________________________________________________________________________________________________________________________________##
##______________________________________________________________________________________________________________________________________________________________________________##
##______________________________________________________________________________________________________________________________________________________________________________##
##______________________________________________________________________________________________________________________________________________________________________________##
##______________________________________________________________________________________________________________________________________________________________________________##
##______________________________________________________________________________________________________________________________________________________________________________##
##______________________________________________________________________________________________________________________________________________________________________________##
##______________________________________________________________________________________________________________________________________________________________________________##
##______________________________________________________________________________________________________________________________________________________________________________##
##______________________________________________________________________________________________________________________________________________________________________________##
##______________________________________________________________________________________________________________________________________________________________________________##
##______________________________________________________________________________________________________________________________________________________________________________##
##______________________________________________________________________________________________________________________________________________________________________________##
##______________________________________________________________________________________________________________________________________________________________________________##
##______________________________________________________________________________________________________________________________________________________________________________##
##______________________________________________________________________________________________________________________________________________________________________________##
##______________________________________________________________________________________________________________________________________________________________________________##
##______________________________________________________________________________________________________________________________________________________________________________##
##______________________________________________________________________________________________________________________________________________________________________________##
##______________________________________________________________________________________________________________________________________________________________________________##
##______________________________________________________________________________________________________________________________________________________________________________##
##______________________________________________________________________________________________________________________________________________________________________________##
##______________________________________________________________________________________________________________________________________________________________________________##
##______________________________________________________________________________________________________________________________________________________________________________##
##______________________________________________________________________________________________________________________________________________________________________________##
##______________________________________________________________________________________________________________________________________________________________________________##
##______________________________________________________________________________________________________________________________________________________________________________##
##______________________________________________________________________________________________________________________________________________________________________________##
##______________________________________________________________________________________________________________________________________________________________________________##
##______________________________________________________________________________________________________________________________________________________________________________##
##______________________________________________________________________________________________________________________________________________________________________________##
##______________________________________________________________________________________________________________________________________________________________________________##
##______________________________________________________________________________________________________________________________________________________________________________##
##______________________________________________________________________________________________________________________________________________________________________________##
##______________________________________________________________________________________________________________________________________________________________________________##
##______________________________________________________________________________________________________________________________________________________________________________##
##______________________________________________________________________________________________________________________________________________________________________________##
##______________________________________________________________________________________________________________________________________________________________________________##
##______________________________________________________________________________________________________________________________________________________________________________##
##______________________________________________________________________________________________________________________________________________________________________________##
##______________________________________________________________________________________________________________________________________________________________________________##
##################################################################################################################################################################################
##################################################################################################################################################################################

