##################################################################################################################################################################################
##################################################################################################################################################################################
##################################################################################################################################################################################
##################################################################################################################################################################################
##########################################################__________________________________________________________##############################################################
##########################################################________________________________________________________________########################################################
#######################################################____________________________________________________________________#######################################################
#########################################________________________________________________________________________________________________#########################################
#####################################____________________________________________________________________________________________________#########################################
###################################____________________________________________________________________________________________________________###################################
###################################____________________________________________________________________________________________________________###################################
##############################_________________________________________________________________________________________________________________###################################
##############################______________________________________________________________________________________________________________________##############################
##############################______________________________________________________________________________________________________________________##############################
###########################_________________________________________________________________________________________________________________________##############################
###########################_____________________________________________________________________________________________________________________________##########################
##########################______________________________________________________________________________________________________________________________##########################
##########################______________________________________________________________________________________________________________________________##########################
#######################______________________________________________________________________________________________________________________________________#####################
#####################_________________________________________________________________________________________________________________________________________####################
###################____________________________________________________________________________________________________________________________________________###################
##################______________________________________________________________________________________________________________________________________________##################
#################________________________________________________________________________________________________________________________________________________#################
#################________________________________________________________________________________________________________________________________________________#################
################__________________________________________________________________________________________________________________________________________________################
################__________________________________________________________________________________________________________________________________________________################
###############____________________________________________________________________________________________________________________________________________________###############
###############____________________________________________________________________________________________________________________________________________________###############
##############______________________________________________________________________________________________________________________________________________________##############
##############______________________________________________________________________________________________________________________________________________________##############
#############________________________________________________________________________________________________________________________________________________________#############
#############________________________________________________________________________________________________________________________________________________________#############
#############_________________________________________________________________________________________________________________________________________________________############
#############_________________________________________________________________________________________________________________________________________________________############
############___________________________________________________________________________________________________________________________________________________________###########
############___________________________________________________________________________________________________________________________________________________________###########
############___________________________________________________________________________________________________________________________________________________________###########
############___________________________________________________________________________________________________________________________________________________________###########
############___________________________________________________________________________________________________________________________________________________________###########
############___________________________________________________________________________________________________________________________________________________________###########
############___________________________________________________________________________________________________________________________________________________________###########
############___________________________________________________________________________________________________________________________________________________________###########
############___________________________________________________________________________________________________________________________________________________________###########
############___________________________________________________________________________________________________________________________________________________________###########
############___________________________________________________________________________________________________________________________________________________________###########
############___________________________________________________________________________________________________________________________________________________________###########
############___________________________________________________________________________________________________________________________________________________________###########
############___________________________________________________________________________________________________________________________________________________________###########
############___________________________________________________________________________________________________________________________________________________________###########
############___________________________________________________________________________________________________________________________________________________________###########
############___________________________________________________________________________________________________________________________________________________________###########
############___________________________________________________________________________________________________________________________________________________________###########
############___________________________________________________________________________________________________________________________________________________________###########
############___________________________________________________________________________________________________________________________________________________________###########
############___________________________________________________________________________________________________________________________________________________________###########
############___________________________________________________________________________________________________________________________________________________________###########
############___________________________________________________________________________________________________________________________________________________________###########
############___________________________________________________________________________________________________________________________________________________________###########
############__________________________________________________________________________________________________________________________________________________________############
############__________________________________________________________________________________________________________________________________________________________############
#############________________________________________________________________________________________________________________________________________________________#############
#############________________________________________________________________________________________________________________________________________________________#############
##############______________________________________________________________________________________________________________________________________________________##############
##############______________________________________________________________________________________________________________________________________________________##############
###############____________________________________________________________________________________________________________________________________________________###############
###############____________________________________________________________________________________________________________________________________________________###############
################__________________________________________________________________________________________________________________________________________________################
################__________________________________________________________________________________________________________________________________________________################
#################________________________________________________________________________________________________________________________________________________#################
##################______________________________________________________________________________________________________________________________________________##################
###################____________________________________________________________________________________________________________________________________________###################
####################__________________________________________________________________________________________________________________________________________####################
#####################________________________________________________________________________________________________________________________________________#####################
######################______________________________________________________________________________________________________________________________________######################
#######################____________________________________________________________________________________________________________________________________#######################
########################__________________________________________________________________________________________________________________________________########################
#########################________________________________________________________________________________________________________________________________#########################
##########################______________________________________________________________________________________________________________________________##########################
###########################____________________________________________________________________________________________________________________________###########################
############################__________________________________________________________________________________________________________________________############################
#############################________________________________________________________________________________________________________________________#############################
##############################______________________________________________________________________________________________________________________##############################
###############################____________________________________________________________________________________________________________________###############################
################################__________________________________________________________________________________________________________________################################
##################################______________________________________________________________________________________________________________##################################
####################################__________________________________________________________________________________________________________####################################
######################################______________________________________________________________________________________________________######################################
########################################__________________________________________________________________________________________________########################################
##########################################______________________________________________________________________________________________##########################################
############################################__________________________________________________________________________________________############################################
##############################################______________________________________________________________________________________##############################################
##################################################______________________________________________________________________________##################################################
######################################################______________________________________________________________________######################################################
##########################################################______________________________________________________________##########################################################
####################################################################################_________________#############################################################################
##################################################################################################################################################################################
##################################################################################################################################################################################
##################################################################################################################################################################################
##################################################################################################################################################################################
##################################################################################################################################################################################
##################################################################################################################################################################################
