##################################################################################################################################################################################
#xxxxxxxxxxxxxxxxxxxxxxxxxxxx_________________________________________________________________________________...................................................................#
#xxxxxxxxxxxxxxxxxxxxxxxxxxxx_________________________________________________________________________________...................................................................#
#xxxxxxxxxxxxxxxxxxxxxxxxxxxx_________________________________________________________________________________...................................................................#
#xxxxxxxxxxxxxxxxxxxxxxxxxxxx_________________________________________________________________________________...................................................................#
#xxxxxxxxxxxxxxxxxxxxxxxxxxxx_________________________________________________________________________________...................................................................#
#xxxxxxxxxxxxxxxxxxxxxxxxxxxx_________________________________________________________________________________...................................................................#
#xxxxxxxxxxxxxxxxxxxxxxxxxxxx_________________________________________________________________________________...................................................................#
#xxxxxxxxxxxxxxxxxxxxxxxxxxxx_________________________________________________________________________________...................................................................#
#xxxxxxxxxxxxxxxxxxxxxxxxxxxx_________________________________________________________________________________...................................................................#
#xxxxxxxxxxxxxxxxxxxxxxxxxxxx_________________________________________________________________________________...................................................................#
#xxxxxxxxxxxxxxxxxxxxxxxxxxxx_________________________________________________________________________________...................................................................#
#xxxxxxxxxxxxxxxxxxxxxxxxxxxx_________________________________________________________________________________...................................................................#
#_____________________________________________________________________________________________________________...................................................................#
#_____________________________________________________________________________________________________________...................................................................#
#_____________________________________________________________________________________________________________...................................................................#
#_____________________________________________________________________________________________________________...................................................................#
#_____________________________________________________________________________________________________________...................................................................#
#_____________________________________________________________________________________________________________...................................................................#
#_____________________________________________________________________________________________________________...................................................................#
#_____________________________________________________________________________________________________________...................................................................#
#_____________________________________________________________________________________________________________...................................................................#
#_____________________________________________________________________________________________________________...................................................................#
#_____________________________________________________________________________________________________________...................................................................#
#_____________________________________________________________________________________________________________...................................................................#
#_____________________________________________________________________________________________________________...................................................................#
#_____________________________________________________________________________________________________________...................................................................#
#_____________________________###########_____________________________________________________________________...................................................................#
#_____________________________###########_____________________________________________________________________...................................................................#
#_____________________________###########_____________________________________________________________________...................................................................#
#_____________________________###########_____________________________________________________________________...................................................................#
#_____________________________###########_____________________________________________________________________...................................................................#
#_____________________________###########_____________________________________________________________________...................................................................#
#_____________________________###########_____________________________________________________________________...................................................................#
#_____________________________###########_____________________________________________________________________...................................................................#
#_____________________________###########_____________________________________________________________________...................................................................#
#_____________________________###########_____________________________________________________________________...................................................................#
#_____________________________###########_____________________________________________________________________...................................................................#
#_____________________________________________________________________________________________________________...................................................................#
#_____________________________________________________________________________________________________________...................................................................#
#_____________________________________________________________________________________________________________...................................................................#
#_____________________________________________________________________________________________________________...................................................................#
#_____________________________________________________________________________________________________________...................................................................#
#_____________________________________________________________________________________________________________...................................................................#
#_____________________________________________________________________________________________________________...................................................................#
#_____________________________________________________________________________________________________________...................................................................#
#_____________________________________________________________________________________________________________...................................................................#
#_____________________________________________________________________________________________________________...................................................................#
#_____________________________________________________________________________________________________________...................................................................#
#_____________________________________________________________________________________________________________...................................................................#
#_____________________________________________________________________________________________________________...................................................................#
#_____________________________________________________________________________________________________________...................................................................#
#________________________________________________________________________________________________________________________________________________________________________________#
#________________________________________________________________________________________________________________________________________________________________________________#
#________________________________________________________________________________________________________________________________________________________________________________#
#________________________________________________________________________________________________________________________________________________________________________________#
#________________________________________________________________________________________________________________________________________________________________________________#
#________________________________________________________________________________________________________________________________________________________________________________#
#________________________________________________________________________________________________________________________________________________________________________________#
#________________________________________________________________________________________________________________________________________________________________________________#
#________________________________________________________________________________________________________________________________________________________________________________#
#________________________________________________________________________________________________________________________________________________________________________________#
#________________________________________________________________________________________________________________________________________________________________________________#
#________________________________________________________________________________________________________________________________________________________________________________#
#________________________________________________________________________________________________________________________________________________________________________________#
#________________________________________________________________________________________________________________________________________________________________________________#
#________________________________________________________________________________________________________________________________________________________________________________#
#________________________________________________________________________________________________________________________________________________________________________________#
#________________________________________________________________________________________________________________________________________________________________________________#
#________________________________________________________________________________________________________________________________________________________________________________#
#________________________________________________________________________________________________________________________________________________________________________________#
#________________________________________________________________________________________________________________________________________________________________________________#
#________________________________________________________________________________________________________________________________________________________________________________#
#________________________________________________________________________________________________________________________________________________________________________________#
#________________________________________________________________________________________________________________________________________________________________________________#
#________________________________________________________________________________________________________________________________________________________________________________#
#________________________________________________________________________________________________________________________________________________________________________________#
#________________________________________________________________________________________________________________________________________________________________________________#
#________________________________________________________________________________________________________________________________________________________________________________#
#________________________________________________________________________________________________________________________________________________________________________________#
#________________________________________________________________________________________________________________________________________________________________________________#
#________________________________________________________________________________________________________________________________________________________________________________#
#________________________________________________________________________________________________________________________________________________________________________________#
#________________________________________________________________________________________________________________________________________________________________________________#
#________________________________________________________________________________________________________________________________________________________________________________#
#________________________________________________________________________________________________________________________________________________________________________________#
#________________________________________________________________________________________________________________________________________________________________________________#
#________________________________________________________________________________________________________________________________________________________________________________#
#________________________________________________________________________________________________________________________________________________________________________________#
#________________________________________________________________________________________________________________________________________________________________________________#
#________________________________________________________________________________________________________________________________________________________________________________#
#________________________________________________________________________________________________________________________________________________________________________________#
#________________________________________________________________________________________________________________________________________________________________________________#
#________________________________________________________________________________________________________________________________________________________________________________#
#________________________________________________________________________________________________________________________________________________________________________________#
#________________________________________________________________________________________________________________________________________________________________________________#
#________________________________________________________________________________________________________________________________________________________________________________#
#________________________________________________________________________________________________________________________________________________________________________________#
#________________________________________________________________________________________________________________________________________________________________________________#
#________________________________________________________________________________________________________________________________________________________________________________#
##################################################################################################################################################################################
