##################################################################################################################################################################################
#________________________________________________________________________________________________________________________________________________________________________________#
#________________________________________________________________________________________________________________________________________________________________________________#
#________________________________________________________________________________________________________________________________________________________________________________#
#________________________________________________________________________________________________________________________________________________________________________________#
#________________________________________________________________________________________________________________________________________________________________________________#
#________________________________________________________________________________________________________________________________________________________________________________#
#________________________________________________________________________________________________________________________________________________________________________________#
#________________________________________________________________________________________________________________________________________________________________________________#
#________________________________________________________________________________________________________________________________________________________________________________#
#________________________________________________________________________________________________________________________________________________________________________________#
#________________________________________________________________________________________________________________________________________________________________________________#
#________________________________________________________________________________________________________________________________________________________________________________#
#________________________________________________________________________________________________________________________________________________________________________________#
#________________________________________________________________________________________________________________________________________________________________________________#
#________________________________________________________________________________________________________________________________________________________________________________#
#________________________________________________________________________________________________________________________________________________________________________________#
#______________________#######################################################################################################################################____________________#
#_____________________#______________________________________________________________________________________________________________________________________#___________________#
#___________________#_________________________________________________________________________________________________________________________________________#__________________#
#_________________#____________________________________________________________________________________________________________________________________________#_________________#
#________________#______________________________________________________________________________________________________________________________________________#________________#
#_______________#________________________________________________________________________________________________________________________________________________#_______________#
#_______________#________________________________________________________________________________________________________________________________________________#_______________#
#______________#__________________________________________________________________________________________________________________________________________________#______________#
#______________#__________________________________________________________________________________________________________________________________________________#______________#
#_____________#____________________________________________________________________________________________________________________________________________________#_____________#
#_____________#____________________________________________________________________________________________________________________________________________________#_____________#
#____________#______________________________________________________________________________________________________________________________________________________#_____________#
#____________#______________________________________________________________________________________________________________________________________________________#____________#
#___________#________________________________________________________________________________________________________________________________________________________#__________#
#___________#________________________________________________________________________________________________________________________________________________________#__________#
#__________#__________________________________________________________________________________________________________________________________________________________#________#
#__________#__________________________________________________________________________________________________________________________________________________________#________#
#________##____________________________________________________________________________________________________________________________________________________________#______________________#
#________##____________________________________________________________________________________________________________________________________________________________#______________________#
#________##____________________________________________________________________________________________________________________________________________________________#______________________#
#________##____________________________________________________________________________________________________________________________________________________________#______________________#
#________##____________________________________________________________________________________________________________________________________________________________#______________________#
#________##____________________________________________________________________________________________________________________________________________________________#______________________#
#________##____________________________________________________________________________________________________________________________________________________________#______________________#
#________##____________________________________________________________________________________________________________________________________________________________#______________________#
#________##____________________________________________________________________________________________________________________________________________________________#______________________#
#________##____________________________________________________________________________________________________________________________________________________________#______________________#
#________##____________________________________________________________________________________________________________________________________________________________#______________________#
#________##____________________________________________________________________________________________________________________________________________________________#______________________#
#________##____________________________________________________________________________________________________________________________________________________________#______________________#
#________##____________________________________________________________________________________________________________________________________________________________#______________________#
#________##____________________________________________________________________________________________________________________________________________________________#______________________#
#________##____________________________________________________________________________________________________________________________________________________________#______________________#
#________##____________________________________________________________________________________________________________________________________________________________#______________________#
#________##____________________________________________________________________________________________________________________________________________________________#______________________#
#________##____________________________________________________________________________________________________________________________________________________________#______________________#
#________##____________________________________________________________________________________________________________________________________________________________#______________________#
#________##____________________________________________________________________________________________________________________________________________________________#______________________#
#________##____________________________________________________________________________________________________________________________________________________________#______________________#
#________##____________________________________________________________________________________________________________________________________________________________#______________________#
#________##____________________________________________________________________________________________________________________________________________________________#______________________#
#__________#__________________________________________________________________________________________________________________________________________________________#_______#
#__________#__________________________________________________________________________________________________________________________________________________________#________#
#___________#________________________________________________________________________________________________________________________________________________________#__________#
#___________#________________________________________________________________________________________________________________________________________________________#__________#
#____________#______________________________________________________________________________________________________________________________________________________#____________#
#____________#______________________________________________________________________________________________________________________________________________________#_____________#
#_____________#____________________________________________________________________________________________________________________________________________________#_____________#
#_____________#____________________________________________________________________________________________________________________________________________________#_____________#
#______________#__________________________________________________________________________________________________________________________________________________#______________#
#______________#__________________________________________________________________________________________________________________________________________________#______________#
#_______________#________________________________________________________________________________________________________________________________________________#_______________#
#________________#______________________________________________________________________________________________________________________________________________#________________#
#_________________#____________________________________________________________________________________________________________________________________________#_________________#
#__________________#__________________________________________________________________________________________________________________________________________#__________________#
#___________________#________________________________________________________________________________________________________________________________________#___________________#
#____________________#______________________________________________________________________________________________________________________________________#___________________#
#_____________________#____________________________________________________________________________________________________________________________________#_______________________#
#______________________#__________________________________________________________________________________________________________________________________#________________________#
#_______________________#________________________________________________________________________________________________________________________________#_________________________#
#________________________#______________________________________________________________________________________________________________________________#__________________________#
#_________________________#____________________________________________________________________________________________________________________________#___________________________#
#__________________________#__________________________________________________________________________________________________________________________#____________________________#
#___________________________#________________________________________________________________________________________________________________________#_____________________________#
#____________________________#______________________________________________________________________________________________________________________#______________________________#
#_____________________________#____________________________________________________________________________________________________________________#_______________________________#
#______________________________#__________________________________________________________________________________________________________________#________________________________#
#_______________________________##______________________________________________________________________________________________________________##___________________________________#
#_________________________________##__________________________________________________________________________________________________________##____________________________________#
#___________________________________##______________________________________________________________________________________________________##_______________________________________#
#_____________________________________##__________________________________________________________________________________________________##________________________________________#
#_______________________________________##______________________________________________________________________________________________##___________________________________________#
#_________________________________________##__________________________________________________________________________________________##____________________________________________#
#___________________________________________##______________________________________________________________________________________##______________________________________________#
#_____________________________________________####______________________________________________________________________________####___________________________________________________#
#_________________________________________________####______________________________________________________________________####_____________________________________________________#
#_____________________________________________________####______________________________________________________________####_____________________________________________________________#
#_________________________________________________________##########################_________________###################_______________________________________________________________#
#__________________________________________________________________________________###############______________________________________________________________________________#
#________________________________________________________________________________________________________________________________________________________________________________#
#________________________________________________________________________________________________________________________________________________________________________________#
#________________________________________________________________________________________________________________________________________________________________________________#
#________________________________________________________________________________________________________________________________________________________________________________#
##################################################################################################################################################################################
