##################################################################################################################################################################################
##################################################################################################################################################################################
##################################################################################################################################################################################
##################################################################################################################################################################################
##################################################################################################################################################################################
##################################################################################################################################################################################
##################################################################################################################################################################################
##################################################################################################################################################################################
##################################################################################################################################################################################
##################################################################################################################################################################################
##################################################################################################################################################################################
##################################################################################################################################################################################
##################################################################################################################################################################################
##################################################################################################################################################################################
##################################################################################################################################################################################
##################################################################################################################################################################################
##################################################################################################################################################################################
##################################################################################################################################################################################
##################################################################################################################################################################################
##################################################################################################################################################################################
##################################################################################################################################################################################
##################################################################################################################################################################################
##################################################################################################################################################################################
##################################################################################################################################################################################
##################################################################################################################################################################################
##################################################################################################################################################################################
#________________________________________________________________________________________________________________________________________________________________________________#
#________________________________________________________________________________________________________________________________________________________________________________#
#________________________________________________________________________________________________________________________________________________________________________________#
#________________________________________________________________________________________________________________________________________________________________________________#
#________________________________________________________________________________________________________________________________________________________________________________#
#________________________________________________________________________________________________________________________________________________________________________________#
#________________________________________________________________________________________________________________________________________________________________________________#
#________________________________________________________________________________________________________________________________________________________________________________#
#________________________________________________________________________________________________________________________________________________________________________________#
#________________________________________________________________________________________________________________________________________________________________________________#
#________________________________________________________________________________________________________________________________________________________________________________#
#________________________________________________________________________________________________________________________________________________________________________________#
#________________________________________________________________________________________________________________________________________________________________________________#
#________________________________________________________________________________________________________________________________________________________________________________#
#________________________________________________________________________________________________________________________________________________________________________________#
#________________________________________________________________________________________________________________________________________________________________________________#
#________________________________________________________________________________________________________________________________________________________________________________#
#________________________________________________________________________________________________________________________________________________________________________________#
#________________________________________________________________________________________________________________________________________________________________________________#
#________________________________________________________________________________________________________________________________________________________________________________#
#________________________________________________________________________________________________________________________________________________________________________________#
#________________________________________________________________________________________________________________________________________________________________________________#
#________________________________________________________________________________________________________________________________________________________________________________#
#________________________________________________________________________________________________________________________________________________________________________________#
#_____________####################################_______________________________________________________________________________________________________________________________#
#________________________________________________________________________________________________________________________________________________________________________________#
#________________________________________________________________________________________________________________________________________________________________________________#
#________________________________________________________________________________________________________________________________________________________________________________#
#________________________________________________________________________________________________________________________________________________________________________________#
#________________________________________________________________________________________________________________________________________________________________________________#
#________________________________________________________________________________________________________________________________________________________________________________#
#________________________________________________________________________________________________________________________________________________________________________________#
#________________________________________________________________________________________________________________________________________________________________________________#
#________________________________________________________________________________________________________________________________________________________________________________#
#________________________________________________________________________________________________________________________________________________________________________________#
#________________________________________________________________________________________________________________________________________________________________________________#
#________________________________________________________________________________________________________________________________________________________________________________#
#________________________________________________________________________________________________________________________________________________________________________________#
#________________________________________________________________________________________________________________________________________________________________________________#
#________________________________________________________________________________________________________________________________________________________________________________#
#________________________________________________________________________________________________________________________________________________________________________________#
#________________________________________________________________________________________________________________________________________________________________________________#
#________________________________________________________________________________________________________________________________________________________________________________#
#________________________________________________________________________________________________________________________________________________________________________________#
#________________________________________________________________________________________________________________________________________________________________________________#
#________________________________________________________________________________________________________________________________________________________________________________#
#________________________________________________________________________________________________________________________________________________________________________________#
#________________________________________________________________________________________________________________________________________________________________________________#
#________________________________________________________________________________________________________________________________________________________________________________#
#________________________________________________________________________________________________________________________________________________________________________________#
#________________________________________________________________________________________________________________________________________________________________________________#
#________________________________________________________________________________________________________________________________________________________________________________#
#________________________________________________________________________________________________________________________________________________________________________________#
#________________________________________________________________________________________________________________________________________________________________________________#
#________________________________________________________________________________________________________________________________________________________________________________#
#________________________________________________________________________________________________________________________________________________________________________________#
#________________________________________________________________________________________________________________________________________________________________________________#
#________________________________________________________________________________________________________________________________________________________________________________#
#________________________________________________________________________________________________________________________________________________________________________________#
#________________________________________________________________________________________________________________________________________________________________________________#
#________________________________________________________________________________________________________________________________________________________________________________#
#________________________________________________________________________________________________________________________________________________________________________________#
#________________________________________________________________________________________________________________________________________________________________________________#
#________________________________________________________________________________________________________________________________________________________________________________#
#________________________________________________________________________________________________________________________________________________________________________________#
#________________________________________________________________________________________________________________________________________________________________________________#
#________________________________________________________________________________________________________________________________________________________________________________#
#________________________________________________________________________________________________________________________________________________________________________________#
#________________________________________________________________________________________________________________________________________________________________________________#
#________________________________________________________________________________________________________________________________________________________________________________#
#________________________________________________________________________________________________________________________________________________________________________________#
#________________________________________________________________________________________________________________________________________________________________________________#
#________________________________________________________________________________________________________________________________________________________________________________#
#________________________________________________________________________________________________________________________________________________________________________________#
##################################################################################################################################################################################
