##################################################################################################################################################################################
##################################################################################################################################################################################
##################################################################################################################################################################################
##################################################################################################################################################################################
##################################################################################################################################################################################
##################################################################################################################################################################################
##################################################################################################################################################################################
##################################################################################################################################################################################
##################################################################################################################################################################################
##################################################################################################################################################################################
##################################################################################################################################################################################
##################################################################################################################################################################################
##################_______________________________________________________________________________________________________________________________________________#################
##################_______________________________________________________________________________________________________________________________________________#################
##################_______________________________________________________________________________________________________________________________________________#################
##################_______________________________________________________________________________________________________________________________________________#################
##################_______________________________________________________________________________________________________________________________________________#################
##################_______________________________________________________________________________________________________________________________________________#################
##################_______________________________________________________________________________________________________________________________________________#################
##################_______________________________________________________________________________________________________________________________________________#################
##################_______________________________________________________________________________________________________________________________________________#################
##################_______________________________________________________________________________________________________________________________________________#################
#################________________________________________________________________________________________________________________________________________________#################
#################________________________________________________________________________________________________________________________________________________#################
################________________________________________________________________________________________________________________________________________________##################
################_______________________________________________________________________________________________________________________________________________###################
###############_______________________________________________________________________________________________________________________________________________####################
###############______________________________________________________________________________________________________________________________________________#####################
##############______________________________________________________________________________________________________________________________________________######################
##############_____________________________________________________________________________________________________________________________________________#######################
#################__________________________________________________________________________________________________________________________________________#######################
#################__________________________________________________________________________________________________________________________________________#######################
#################__________________________________________________________________________________________________________________________________________#######################
#################__________________________________________________________________________________________________________________________________________#######################
#################__________________________________________________________________________________________________________________________________________#######################
#############______________________________________________________________________________________________________________________________________________#######################
#############______________________________________________________________________________________________________________________________________________#######################
#############______________________________________________________________________________________________________________________________________________#######################
#############______________________________________________________________________________________________________________________________________________#######################
#############______________________________________________________________________________________________________________________________________________#######################
#############______________________________________________________________________________________________________________________________________________#######################
#############______________________________________________________________________________________________________________________________________________#######################
#############______________________________________________________________________________________________________________________________________________#######################
#############______________________________________________________________________________________________________________________________________________#######################
#############_______________________________________________________________________________________________________________________________________________######################
#############_______________________________________________________________________________________________________________________________________________######################
#############_______________________________________________________________________________________________________________________________________________######################
#############_______________________________________________________________________________________________________________________________________________######################
#############_______________________________________________________________________________________________________________________________________________######################
############________________________________________________________________________________________________________________________________________________######################
############________________________________________________________________________________________________________________________________________________######################
############________________________________________________________________________________________________________________________________________________######################
############________________________________________________________________________________________________________________________________________________######################
############________________________________________________________________________________________________________________________________________________######################
############________________________________________________________________________________________________________________________________________________######################
############________________________________________________________________________________________________________________________________________________######################
############________________________________________________________________________________________________________________________________________________######################
############________________________________________________________________________________________________________________________________________________######################
############_________________________________________________________________________________________________________________________________________________#####################
############_________________________________________________________________________________________________________________________________________________#####################
############_________________________________________________________________________________________________________________________________________________#####################
#################____________________________________________________________________________________________________________________________________________#####################
#################_______________________________________________________________________________________________________________________________________________##################
#################_______________________________________________________________________________________________________________________________________________##################
#################_______________________________________________________________________________________________________________________________________________##################
#################_______________________________________________________________________________________________________________________________________________##################
#################_______________________________________________________________________________________________________________________________________________##################
#################_______________________________________________________________________________________________________________________________________________##################
#################_________________________________________________________________________________________________________________________________________________################
#############_____________________________________________________________________________________________________________________________________________________################
#############_____________________________________________________________________________________________________________________________________________________################
#############_____________________________________________________________________________________________________________________________________________________################
#############_____________________________________________________________________________________________________________________________________________________################
#############_____________________________________________________________________________________________________________________________________________________################
#############_____________________________________________________________________________________________________________________________________________________################
#############_____________________________________________________________________________________________________________________________________________________################
#############_____________________________________________________________________________________________________________________________________________________################
#############_____________________________________________________________________________________________________________________________________________________################
#############__________________________________________________________________________________________________________________________________________________________###########
#############__________________________________________________________________________________________________________________________________________________________###########
#############__________________________________________________________________________________________________________________________________________________________###########
#############__________________________________________________________________________________________________________________________________________________________###########
#############__________________________________________________________________________________________________________________________________________________________###########
#############__________________________________________________________________________________________________________________________________________________________###########
#############__________________________________________________________________________________________________________________________________________________________###########
#############__________________________________________________________________________________________________________________________________________________________###########
#############__________________________________________________________________________________________________________________________________________________________###########
#############__________________________________________________________________________________________________________________________________________________________###########
#############__________________________________________________________________________________________________________________________________________________________###########
#############__________________________________________________________________________________________________________________________________________________________###########
#############__________________________________________________________________________________________________________________________________________________________###########
#############__________________________________________________________________________________________________________________________________________________________###########
#############__________________________________________________________________________________________________________________________________________________________###########
####################___________________________________________________________________________________________________________________________________________________###########
####################___________________________________________________________________________________________________________________________________________________###########
##################################################################################################################################################################################
##################################################################################################################################################################################
##################################################################################################################################################################################
##################################################################################################################################################################################
##################################################################################################################################################################################
##################################################################################################################################################################################