##################################################################################################################################################################################
##################################################################################################################################################################################
##################################################################################################################################################################################
##################################################################################################################################################################################
##################################################################################################################################################################################
##################################################################################################################################################################################
##################################################################################################################################################################################
##################################################################################################################################################################################
##################################################################################################################################################################################
##################################################################################################################################################################################
##################################################################################################################################################################################
##################################################################################################################################################################################
######################__________________________________________________________________________________________________________________________________##########################
####################____________________________________________________________________________________________________________________________________##########################
####################____________________________________________________________________________________________________________________________________##########################
####################____________________________________________________________________________________________________________________________________##########################
####################_____________________________________________________________________________________________________________________________________#########################
####################_____________________________________________________________________________________________________________________________________#########################
####################_____________________________________________________________________________________________________________________________________#########################
####################_____________________________________________________________________________________________________________________________________#########################
###################_____________________________________________________________________________________________________________________________________##########################
###################_____________________________________________________________________________________________________________________________________##########################
###################_____________________________________________________________________________________________________________________________________##########################
###################_____________________________________________________________________________________________________________________________________##########################
###################_____________________________________________________________________________________________________________________________________##########################
###################_____________________________________________________________________________________________________________________________________##########################
##################______________________________________________________________________________________________________________________________________##########################
#################_______________________________________________________________________________________________________________________________________##########################
#################_______________________________________________________________________________________________________________________________________##########################
#################_______________________________________________________________________________________________________________________________________##########################
#################________________________________________________________________________________________________________________________________________#########################
#################________________________________________________________________________________________________________________________________________#########################
#################________________________________________________________________________________________________________________________________________#########################
#################________________________________________________________________________________________________________________________________________#########################
#################_________________________________________________________________________________________________________________________________________########################
#################_________________________________________________________________________________________________________________________________________########################
#################_________________________________________________________________________________________________________________________________________########################
#################____________________________________________________________________________________________________________________________________________#####################
#################____________________________________________________________________________________________________________________________________________#####################
#################______________________________________________________________________________________________________________________________________________###################
#################______________________________________________________________________________________________________________________________________________###################
#################______________________________________________________________________________________________________________________________________________###################
#################______________________________________________________________________________________________________________________________________________###################
##################________________________________________________________________________________________________________________________________________________################
##################________________________________________________________________________________________________________________________________________________################
##################________________________________________________________________________________________________________________________________________________################
###################______________________________________________________________________________________________________________________________________________#################
####################____________________________________________________________________________________________________________________________________________##################
##################################################################################################################################################################################
##################################################################################################################################################################################
##################################################################################################################################################################################